............................................#######
............................................#.....#
............................................#.....#
............................................#.....#
............................................#.....#
............................................#.....#
........................................###########
........................................#...#......
....................................#########......
....................................#...#..........
..................................#########........
..................................#.#...#.#........
..................................#.#...#.#........
..................................#.#...#.#........
..................................#.#...#########..
..................................#.#.....#.....#..
..........................###########.....#.....#..
..........................#.......#.......#.....#..
........................###########.......#.....#..
........................#.#...............#.....#..
........................#.#...............#######..
........................#.#........................
..............#########.#.#........................
..............#.......#.#.#........................
#######.......#...#########........................
#.....#.......#...#...#.#..........................
#.....#.......#.#########..........................
#.....#.......#.#.#...#............................
#.....#.......#.#.#...#............................
#.....#.......#.#.#...#............................
#########.....#.#.#...#############................
......#.#.....#.#.#...............#................
......#.#.....#.#.#############...#................
......#.#.....#.#.............#...#................
......#########.#.............#...#................
........#.......#.............#...#................
........#.......#.............#...#................
........#.......#.............#...#................
........#########.........#########................
..............................#....................
..............................#########............
......................................#............
......................................#............
......................................#............
......................................#............
......................................#............
......................................#............
......................................#............
......................................#............
......................................#............
......................................########^....

